B,B,B,B,B,B,B,B,B
B,B,B,B,B,B,B,B,B
B,B,B,B,B,B,B,B,B
B,B,B,B,B,B,B,B,B
B,B,B,B,B,B,B,B,B
B,B,B,B,B,B,B,B,B
B,B,B,B,B,B,B,B,B
B,B,B,B,B,B,B,B,B
B,B,B,B,B,B,B,B,B

N,N,N,N,N,N,N,N,N
N,N,N,N,N,N,N,N,N
N,N,N,N,N,N,N,N,N
N,N,N,N,N,N,N,N,N
N,N,N,N,N,N,N,N,N
N,N,N,N,N,N,B,B,B
N,N,N,N,N,N,B,B,B
N,N,N,N,P,N,B,B,B
N,N,N,N,N,N,N,N,N

N,N,N,N,N,N,N,N,N
N,N,N,B,B,B,N,N,N
N,N,N,B,B,B,N,N,N
N,N,N,B,B,B,N,N,N
N,N,B,N,N,N,N,N,N
N,N,N,N,N,N,N,N,N
N,N,N,N,N,N,N,M,N
N,N,N,N,N,N,N,N,N
N,N,N,N,N,N,N,N,N

N,N,N,N,N,N,N,N,N
N,N,N,N,N,N,N,N,N
N,N,N,N,M,N,N,N,N
N,N,N,N,N,N,N,N,N
N,N,G,N,N,N,N,N,N
N,N,N,N,N,N,N,N,N
N,N,N,N,N,N,N,N,N
N,N,N,N,N,N,N,N,N
N,N,N,N,N,N,N,N,N