B,B,B,B,N,B,B,B,B
B,B,B,B,N,B,B,B,B
B,B,B,B,N,B,B,B,B
B,B,B,B,N,B,B,B,B
B,B,B,B,N,B,B,B,B
B,B,B,B,N,B,B,B,B
B,B,B,B,N,B,B,B,B
B,B,B,B,N,B,B,B,B
B,B,B,B,N,B,B,B,B

N,N,N,N,N,N,N,N,N
N,N,N,N,N,N,N,N,N
N,N,N,N,N,N,N,N,N
N,N,N,N,N,N,N,N,N
N,N,N,N,N,N,N,N,N
N,N,N,N,N,N,B,N,N
N,N,N,N,N,N,N,N,N
N,N,P,N,N,N,P,N,N
N,N,N,N,N,N,N,G,G

N,N,N,N,N,N,N,N,N
N,N,N,N,N,N,N,N,N
N,B,H,H,H,H,H,B,N
N,N,N,N,N,N,N,N,N
N,N,N,N,N,N,N,N,N
N,N,N,N,N,N,S,N,N
N,N,N,N,N,N,N,N,N
N,N,N,N,N,N,N,N,N
N,N,N,N,N,N,N,N,N
